{
    layout: [
        [01, 01, 01, 01, 01, 01, 01, 01, 01, 01],

        [01, 01, 01, 01, 01, 01, 01, 01, 02, 01],

        [01, 01, 01, 12, 01, 01, 10, 01, 01, 01],

        [00, 01, 01, 01, 01, 01, 01, 01, 01, 00],

        [00, 01, 01, 12, 01, 01, 01, 01, 01, 00],

        [00, 01, 01, 01, 11, 01, 01, 01, 01, 00],

        [00, 01, 08, 01, 01, 01, 07, 01, 01, 00],
		
        [01, 03, 01, 01, 01, 01, 04, 01, 01, 01],

        [01, 01, 01, 09, 01, 01, 05, 01, 01, 01],

        [01, 01, 01, 01, 01, 01, 01, 01, 01, 01]
    ],
    connections: [
        {
            activator: [6, 1],
            watcher: [6, 3]
        }
    ],
    rotations: [
        {
            position: [3, 5],
            direction: 1
        },
        {
            position: [3, 1],
            direction: 1
        }
    ]
}
