{
    "width": 10,
    "height": 10,
    "grid": [
        [1, 1, 1, 1, 1, 1, 1, 1, 1, 1],
        [1, 1, 1, 1, 1, 1, 1, 1, 2, 1],
        [1, 1, 1, 10, 1, 1, 9, 1, 1, 1],
        [0, 1, 1, 1, 1, 1, 1, 1, 1, 0],
        [0, 1, 1, 10, 1, 1, 1, 1, 1, 0],
        [0, 1, 1, 1, 1, 1, 7, 1, 1, 0],
        [0, 3, 8, 1, 1, 1, 7, 1, 1, 0],
        [1, 1, 1, 1, 1, 1, 4, 1, 1, 1],
        [1, 1, 1, 1, 1, 1, 5, 1, 1, 1],
        [1, 1, 1, 1, 1, 1, 1, 1, 1, 1]
    ],
    "connections": [
        {
            "activator": [6, 1],
            "watcher": [6, 3]
        }
    ],
    "rotations": [
        {
            "position": [3, 5],
            "direction": 1
        }
    ]
}
