{
    layout: [
        [00, 00, 00, 00, 00, 01, 01, 01, 00, 01, 01, 01, 00, 00, 00, 00],
        [00, 00, 00, 00, 00, 01, 01, 01, 10, 01, 01, 01, 00, 00, 00, 00],
        [01, 01, 01, 01, 06, 01, 01, 01, 01, 01, 01, 12, 06, 01, 01, 01],
        [01, 01, 01, 01, 07, 01, 01, 01, 01, 01, 01, 01, 07, 01, 02, 01],
        [01, 01, 01, 01, 06, 01, 01, 01, 01, 01, 01, 01, 06, 01, 01, 01],
        [01, 10, 01, 00, 00, 01, 01, 12, 10, 01, 01, 01, 00, 00, 00, 00],
        [01, 01, 01, 00, 00, 01, 01, 01, 00, 01, 01, 01, 00, 00, 00, 00],
        [12, 01, 01, 00, 00, 00, 00, 00, 00, 00, 00, 00, 00, 00, 00, 00],
        [01, 03, 01, 00, 08, 00, 08, 00, 00, 00, 00, 00, 00, 00, 00, 00],
        [01, 01, 01, 00, 00, 00, 00, 00, 00, 00, 00, 00, 00, 00, 00, 00],
    ],
    connections: [
        {
            activator: [1, 4],
            watcher: [4, 6]
        },
        {
            activator: [8, 4],
            watcher: [12, 6]
        },
        {
            activator: [8, 8],
            watcher: [12, 6]
        },

    ],
    rotations: [
        {
            position: [4, 1],
            direction: 1
        },
    ]
}