{
    layout: [
        [00, 00, 00, 00, 00, 00, 01, 01, 01, 00, 00, 00, 00, 00, 00, 00]
        [00, 00, 00, 00, 00, 00, 01, 02, 01, 00, 00, 00, 00, 00, 00, 00]
        [00, 00, 00, 00, 00, 00, 01, 01, 01, 00, 00, 00, 01, 01, 01, 00],
        [00, 00, 00, 00, 00, 00, 07, 15, 07, 00, 00, 00, 01, 14, 01, 16],
        [00, 00, 00, 00, 00, 00, 01, 01, 01, 00, 00, 00, 01, 01, 01, 00],
        [01, 01, 01, 00, 00, 00, 07, 15, 07, 00, 00, 00, 07, 08, 07, 00],
        [01, 14, 01, 00, 01, 01, 01, 01, 01, 01, 01, 00, 01, 01, 01, 00],
        [01, 01, 01, 00, 01, 01, 01, 01, 01, 01, 01, 00, 01, 01, 01, 06],
        [07, 08, 07, 00, 01, 01, 01, 01, 01, 01, 01, 00, 01, 01, 01, 00],
        [01, 01, 01, 00, 01, 01, 01, 01, 01, 01, 01, 00, 07, 08, 07, 00],
        [01, 01, 01, 01, 01, 01, 01, 01, 01, 01, 01, 01, 01, 01, 01, 00],
        [01, 06, 01, 01, 01, 01, 01, 01, 01, 01, 01, 01, 01, 06, 01, 01],
        [01, 01, 01, 01, 01, 01, 01, 01, 01, 01, 01, 01, 01, 01, 01, 00],
        [00, 00, 00, 00, 00, 00, 01, 05, 01, 00, 00, 00, 00, 00, 00, 00],
        [00, 00, 00, 00, 00, 00, 01, 03, 01, 00, 00, 00, 00, 00, 00, 00],
    ],
    entities: [
        { // left door
            position: [1, 6],
            watching: [
                [1, 3],
            ],
        },
        { // right door
            position: [13, 5],
            watching: [
                [13, 3],
            ],
        },
        { // mid door
            position: [13, 9],
            watching: [
                [15, 7],
            ],
        },
        { // jump pad
            position: [15, 11],
            jump_pad_target: [15, 3]
        }
    ]
}