{
    layout: [
        [00, 00, 00, 00, 00, 00, 00, 00, 01, 01, 01, 00, 00, 00, 00, 00, 00, 00, 00],
        [00, 00, 00, 00, 00, 00, 00, 00, 01, 02, 01, 00, 00, 00, 00, 00, 00, 00, 00],
        [00, 00, 00, 00, 00, 00, 00, 00, 01, 01, 01, 00, 00, 00, 00, 00, 00, 00, 00],
        [00, 00, 00, 00, 00, 00, 00, 00, 07, 15, 07, 00, 00, 00, 00, 00, 00, 00, 00],
        [00, 00, 00, 00, 01, 01, 01, 01, 01, 01, 01, 01, 01, 01, 06, 00, 00, 00, 00],
        [00, 00, 00, 00, 01, 01, 01, 01, 01, 01, 01, 01, 01, 01, 01, 00, 00, 00, 00],
        [01, 01, 01, 07, 01, 01, 01, 01, 01, 01, 01, 01, 01, 01, 01, 07, 01, 01, 01],
        [01, 05, 01, 08, 01, 01, 01, 01, 01, 01, 01, 01, 01, 01, 01, 08, 01, 14, 01],
        [01, 01, 01, 07, 01, 01, 01, 01, 01, 01, 01, 01, 01, 01, 01, 07, 01, 01, 01],
        [00, 00, 00, 00, 01, 01, 01, 01, 01, 01, 01, 01, 01, 01, 01, 00, 00, 00, 00],
        [00, 00, 00, 00, 06, 01, 01, 01, 01, 01, 01, 01, 01, 01, 01, 00, 00, 00, 00],
        [00, 00, 00, 00, 00, 00, 00, 00, 07, 05, 07, 00, 00, 00, 00, 00, 00, 00, 00],
        [00, 00, 00, 00, 00, 00, 00, 00, 01, 01, 01, 00, 00, 00, 00, 00, 00, 00, 00],
        [00, 00, 00, 00, 00, 00, 00, 00, 01, 03, 01, 00, 00, 00, 00, 00, 00, 00, 00],
        [00, 00, 00, 00, 00, 00, 00, 00, 01, 01, 01, 00, 00, 00, 00, 00, 00, 00, 00]
    ],
    entities: [
        { // left door
            position: [3, 7],
            watching: [
                [14, 10],
            ],
        },
        { // right door
            position: [15, 7],
            watching: [
                [14, 10],
                [4, 4]
            ],
        }
    ]
}