{
    layout: [
        [00, 00, 00, 01, 00, 00, 11, 00, 00, 00, 00, 00, 00, 00, 00, 00],
        [00, 01, 07, 01, 01, 01, 07, 01, 01, 01, 01, 01, 01, 01, 01, 01],
        [03, 01, 08, 01, 01, 01, 08, 01, 01, 01, 01, 01, 01, 01, 01, 01],
        [00, 01, 07, 01, 01, 13, 07, 01, 01, 01, 01, 01, 01, 01, 01, 01],
        [00, 00, 00, 00, 00, 00, 00, 00, 00, 00, 00, 00, 00, 00, 00, 00],
        [00, 00, 00, 00, 16, 00, 00, 00, 00, 00, 00, 00, 00, 00, 00, 00],
        [00, 01, 01, 01, 01, 01, 01, 01, 01, 01, 01, 01, 01, 01, 01, 01],
        [04, 01, 06, 01, 01, 01, 01, 01, 01, 01, 01, 01, 01, 01, 01, 01],
        [00, 01, 01, 01, 01, 01, 09, 01, 01, 01, 01, 01, 01, 01, 01, 01],
    ],
    entities: [
        { // first door
            position: [2, 6],
            watching: [
                [2, 1]
            ]
        },

        { // launch pad
            position: [4, 3],
            jump_pad_target: [4, 5]
        }
    ],
}

